00000000000000000000000000000000000000000000000000000000000000000000000000000000000000000000000  			
00000000000000000000000000000000000000000000000000000000000000000000000000000000000000000000000  			
00000000000000000000000000000000000000000000000000000000000000000000000000000000000000000000000  			
00000000000000000000000000000000000000000000000000000000000000000000000000000000000000000000000  			
00000000000000000000000000000000000000000000000000000000000000000000000000000000000000000000000  			
00000111111111111111111111111111111111111111111111111111111111111111111111111111111111111100000  			
00000111111111111111111111111111111111111111111111111111111111111111111111111111111111111100000  			
00000111111111111111111111111111111111111111111111111111111111111111111111111111111111111100000  			
00000111111111111111111111111111111111111111111111111111111111111111111111111111111111111100000  			
00000111111111111111111111111111111111111111111111111111111111111111111111111111111111111100000  			
00000111110000000000000000000000000000000000000000000000000000000000000000000000000001111100000  			
00000111110000000000000000000000000000000000000000000000000000000000000000000000000001111100000  			
00000111110000000000000000000000000000000000000000000000000000000000000000000000000001111100000  			
00000111110000000000000000000000000000000000000000000000000000000000000000000000000001111100000  			
00000111110000000000000000000000000000000000000000000000000000000000000000000000000001111100000  			
00000111110000000000000000000000000000000000000000000000000000000000000000000000000001111100000  			
00000111110000000000000000000000000000000000000000000000000000000000000000000000000001111100000  			
00000111110000000000000000000000000000000000000000000000000000000000000000000000000001111100000  			
00000111110000000002220000000000000222000002222222220000022200000000000000000000000001111100000  			
00000111110000000000222000000000002220000002220000000000022200000000000000000000000001111100000  			
00000111110000000000022200022200022200000002222220000000022200000000000000000000000001111100000  			
00000111110000000000002220220220222000000002220000000000022222222200000000000000000001111100000  			
00000111110000000000000222200022220000000002222222220000022222222200000000000000000001111100000  			
00000111110000000000000000000000000000000000000000000000000000000000000000000000000001111100000  			
00000111110000000000000000000000000000000000000000000000000000000000000000000000000001111100000  			
00000111110000000000000000000000000000000000000000000000000000000000000000000000000001111100000  			
00000111110000000000000000000000000000000000000000000000000000000000000000000000000001111100000  			
00000111110000000000000000000000000000000000000000000000000000000000000000000000000001111100000  			
00000111110000000000000000000000000000000000000000000000000000000000000000000000000001111100000  			
00000111110000000000000000000000000000000000000000000000000000000000000000000000000001111100000  			
00000111110000000000000000000000000000000000000000000000000000000000000000000000000001111100000  			
00000111110000000000000000000000000000000000000000000000000000000000000000000000000001111100000  			
00000111110000000000000000000000000000000000000000000000000000000000000000000000000001111100000  			
00000111110000000000000000000000000000000000000000000000000000000000000000000000000001111100000  			
00000111110000000000000000000000000000000000000000000000000000000000000000000000000001111100000  			
00000111110000000000000000000000000000000000000000000000000000000000000000000000000001111100000  			
00000111110000000000000000000000000000000000000000000000000000000000000000000000000001111100000  			
00000111110000000000000000000000000000000000000000000000000000000000000000000000000001111100000  			
00000111110000000000000000000000000000000000000000000000000000000000000000000000000001111100000  			
00000111110000000000000000000000000000000000000000000000000000000000000000000000000001111100000  			
00000111110000000000000000000000000000000000000000000000000000000000000000000000000001111100000  			
00000111110000000000000000000000000000000000000000000000000000000000000000000000000001111100000  			
00000111110000000000000000000000000000000000000000000000000000000000000000000000000001111100000  			
00000111110000000000000000000000000000000000000000000000000000000000000000000000000001111100000  			
00000111110000000000000000000000000000000000000000000000000000000000000000000000000001111100000  			
00000111110000000000000000000000000000000000000000000000000000000000000000000000000001111100000  			
00000111110000000000000000000000000000000000000000000000000000000000000000000000000001111100000  			
00000111110000000000000000000000000000000000000000000000000000000000000000000000000001111100000  			
00000111110000000000000000000000000000000000000000000000000000000000000000000000000001111100000  			
00000111110000000000000000000000000000000000000000000000000000000000000000000000000001111100000  			
00000111110000000000000000000000000000000000000000000000000000000000000000000000000001111100000  			
00000111110000000000000000000000000000000000000000000000000000000000000000000000000001111100000  			
00000111110000000000000000000000000000000000000000000000000000000000000000000000000001111100000  			
00000111110000000000000000000000000000000000000000000000000000000000000000000000000001111100000  			
00000111110000000000000000000000000000000000000000000000000000000000000000000000000001111100000  			
00000111110000000000000000000000000000000000000000000000000000000000000000000000000001111100000  			
00000111110000000000000000000000000000000000000000000000000000000000000000000000000001111100000  			
00000111110000000000000000000000000000000000000000000000000000000000000000000000000001111100000  			
00000111110000000000000000000000000000000000000000000000000000000000000000000000000001111100000  			
00000111110000000000000000000000000000000000000000000000000000000000000000000000000001111100000  			
00000111110000000000000000000000000000000000000000000000000000000000000000000000000001111100000  			
00000111110000000000000000000000000000000000000000000000000000000000000000000000000001111100000  			
00000111110000000000000000000000000000000000000000000000000000000000000000000000000001111100000  			
00000111110000000000000000000000000000000000000000000000000000000000000000000000000001111100000  			
00000111110000000000000000000000000000000000000000000000000000000000000000000000000001111100000  			
00000111110000000000000000000000000000000000000000000000000000000000000000000000000001111100000  			
00000111110000000000000000000000000000000000000000000000000000000000000000000000000001111100000  			
00000111110000000000000000000000000000000000000000000000000000000000000000000000000001111100000  			
00000111110000000000000000000000000000000000000000000000000000000000000000000000000001111100000  			
00000111110000000000000000000000000000000000000000000000000000000000000000000000000001111100000  			
00000111110000000000000000000000000000000000000000000000000000000000000000000000000001111100000  			
00000111110000000000000000000000000000000000000000000000000000000000000000000000000001111100000  			
00000111110000000000000000000000000000000000000000000000000000000000000000000000000001111100000  			
00000111110000000000000000000000000000000000000000000000000000000000000000000000000001111100000  			
00000111110000000000000000000000000000000000000000000000000000000000000000000000000001111100000  			
00000111110000000000000000000000000000000000000000000000000000000000000000000000000001111100000  			
00000111110000000000000000000000000000000000000000000000000000000000000000000000000001111100000  			
00000111110000000000000000000000000000000000000000000000000000000000000000000000000001111100000  			
00000111110000000000000000000000000000000000000000000000000000000000000000000000000001111100000  			
00000111110000000000000000000000000000000000000000000000000000000000000000000000000001111100000  			
00000111110000000000000000000000000000000000000000000000000000000000000000000000000001111100000  			
00000111110000000000000000000000000000000000000000000000000000000000000000000000000001111100000  			
00000111110000000000000000000000000000000000000000000000000000000000000000000000000001111100000  			
00000111110000000000000000000000000000000000000000000000000000000000000000000000000001111100000  			
00000111110000000000000000000000000000000000000000000000000000000000000000000000000001111100000  			
00000111110000000000000000000000000000000000000000000000000000000000000000000000000001111100000  			
00000111110000000000000000000000000000000000000000000000000000000000000000000000000001111100000  			
00000111110000000000000000000000000000000000000000000000000000000000000000000000000001111100000  			
00000111110000000000000000000000000000000000000000000000000000000000000000000000000001111100000  			
00000111110000000000000000000000000000000000000000000000000000000000000000000000000001111100000  			
00000111111111111111111111111111111111111111111111111111111111111111111111111111111111111100000  			
00000111111111111111111111111111111111111111111111111111111111111111111111111111111111111100000  			
00000111111111111111111111111111111111111111111111111111111111111111111111111111111111111100000  			
00000111111111111111111111111111111111111111111111111111111111111111111111111111111111111100000  			
00000111111111111111111111111111111111111111111111111111111111111111111111111111111111111100000  			
00000000000000000000000000000000000000000000000000000000000000000000000000000000000000000000000  			
00000000000000000000000000000000000000000000000000000000000000000000000000000000000000000000000  			
00000000000000000000000000000000000000000000000000000000000000000000000000000000000000000000000  			
00000000000000000000000000000000000000000000000000000000000000000000000000000000000000000000000  			
00000000000000000000000000000000000000000000000000000000000000000000000000000000000000000000000  			

